7,7,B,0,8,8
7,3,3,0,8,5
7,3,3,0,5,5
9,0,0,0,5,7
9,0,1,1,1,7
9,0,A,1,7,7