7,B,0,0,6,6,6
7,7,7,0,6,3,3
1,5,5,0,0,3,3
1,1,5,5,0,7,2
1,5,0,0,0,7,2
5,5,0,7,7,7,2
5,A,0,7,7,7,2