B,9,9,9,9
0,9,1,1,1
0,9,1,1,1
0,1,1,1,1
0,0,1,1,1
1,0,0,1,1
1,1,0,1,8
1,A,0,8,8