3,3,4,B,0,6,6
3,3,4,4,0,6,6
1,1,1,4,0,6,6
9,1,0,0,0,6,6
9,7,0,5,5,6,6
9,7,0,7,5,5,6
7,7,A,7,7,7,6