0,0,0,0,0,B,5,7,7,7
0,2,2,2,2,5,5,4,4,7
0,0,0,3,3,5,4,4,6,6
3,3,0,3,3,5,4,6,6,6
3,3,0,0,5,5,4,4,6,6
6,6,6,0,5,3,3,4,6,2
6,5,0,0,1,3,3,4,4,2
5,5,0,1,1,1,4,4,6,2
5,1,0,0,3,3,6,6,6,2
1,1,1,A,3,3,2,2,2,2