8,8,B,7,7
4,8,0,7,2
4,4,0,7,2
7,4,0,0,2
7,7,7,A,2
