2,0,0,0,0,B,9
2,0,6,6,6,6,9
2,0,0,0,0,0,9
2,5,1,1,1,0,0
5,5,9,1,4,4,0
5,8,9,4,4,6,0
8,8,9,6,6,6,A