2,B,1,8,8
2,0,1,1,8
2,0,1,6,6
2,0,0,0,6
9,9,9,A,6
