1,9,9,9,6,6
1,1,0,0,0,6
1,9,0,2,0,6
6,9,0,2,0,B
6,9,0,2,3,3
6,6,A,2,3,3
