7,7,5,B,6,6
7,5,5,0,2,6
7,5,1,0,2,6
1,1,1,0,2,7
1,1,1,0,2,7
1,A,0,0,7,7