10,10,5,5,8,8
9,9,9,5,5,8
B,0,0,7,7,7
3,3,0,0,0,7
3,3,6,7,0,A
6,6,6,7,7,7
