0,0,0,B,2
0,8,6,6,2
0,8,8,6,2
0,0,0,6,2
3,3,0,0,0
3,3,8,8,0
6,6,6,8,0
6,A,0,0,0