7,7,B,8,8
7,0,0,1,8
7,0,1,1,1
0,0,4,4,8
A,4,4,8,8