B,0,0,0,0
2,2,2,2,0
7,7,4,4,0
7,4,4,0,0
7,0,0,0,6
0,0,6,6,6
0,2,2,2,2
0,0,0,0,A