3,3,B,8,8
3,3,0,9,8
8,8,0,9,7
8,8,0,9,7
8,8,A,7,7
