6,6,6,B,8,8
6,5,5,0,0,8
A,0,5,5,0,2
7,0,0,0,0,2
7,7,7,3,3,2
9,9,9,3,3,2
