8,8,0,0,B
8,0,0,1,2
6,0,1,1,2
6,0,0,1,2
6,6,0,A,2